05
08
#####>##
#...m..#
#$m....#
#.B..@.#
########
04
